jslib/jquery-jvectormap/data/jquery-jvectormap-world-mill-en.js
CODE
===========================================================================
AE	AE	United Arab Emirates
AF  AF	Afghanistan
AG  
AL  AL	Albania
AM  AM	Armenia
AO  AO	Angola
AR  AR	Argentina
AT  AT	Austria
AU  AU	Australia
AZ  AZ	Azerbaijan
BA  BA	Bosnia and Herz.
BB  BD	Bangladesh
BD  
BE  BE	Belgium
BF  BF	Burkina Faso
BG  BG	Bulgaria
BH  
BI  BI	Burundi
BJ  BJ	Benin
BN  BN	Brunei
BO  BO	Bolivia
BR  BR	Brazil
BS  BS	Bahamas
BT  BT	Bhutan
BW  BW	Botswana
BY  BY	Belarus
BZ  BZ	Belize
CA  CA	Canada
CD  CD	Dem. Rep. Congo
CF  CF	Central African Rep.
CG  CG	Congo
CH  CH	Switzerland
CI  CI	CÃ´te d'Ivoire
CL  CL	Chile
CM  CM	Cameroon
CN  CN	China
CO  CO	Colombia
CR  CR	Costa Rica
CV  					CU	Cuba
CY  CY	Cyprus
CZ  CZ	Czech Rep.
DE  DE	Germany
DJ  DJ	Djibouti
DK  DK	Denmark
DM  
DO  DO	Dominican Rep.
DZ  DZ	Algeria
EC  EC	Ecuador
EE  EE	Estonia
EG  EG	Egypt
ER  ER	Eritrea					EH	W. Sahara
ES  ES	Spain
ET  ET	Ethiopia
FI  FI	Finland
FJ  FJ	Fiji
FR  FR	France							FK	Falkland Is.
GA  GA	Gabon
GB  GB	United Kingdom
GD  GE	Georgia
GE  GH	Ghana
GH  GL	Greenland
GM  GM	Gambia
GN  GN	Guinea
GQ  GQ	Eq. Guinea
GR  GR	Greece
GT  GT	Guatemala
GW  GW	Guinea-Bissau
GY  GY	Guyana
HK  
HN  HN	Honduras
HR  HR	Croatia
HT  HT	Haiti
HU  HU	Hungary
ID  ID	Indonesia
IE  IE	Ireland
IL  IL	Israel
IN  IN	India
IQ  IQ	Iraq
IR  IR	Iran
IS  IS	Iceland
IT  IT	Italy
JM  JM	Jamaica
JO  JO	Jordan
JP  JP	Japan
KE  KE	Kenya
KG  KG	Kyrgyzstan
KH  KH	Cambodia
KI  							KP	Dem. Rep. Korea
KM  
KN  
KR  KR	Korea
KW  KW	Kuwait
KZ  KZ	Kazakhstan
LA  LA	Lao PDR
LB  LB	Lebanon
LC  
LK  LK	Sri Lanka
LR  LR	Liberia
LS  LS	Lesotho
LT  LT	Lithuania
LU  LU	Luxembourg
LV  LV	Latvia
LY  LY	Libya
MA  MA	Morocco
MD  MD	Moldova
ME  ME	Montenegro
MG  MG	Madagascar
MK  MK	Macedonia
ML  ML	Mali
MM  MM	Myanmar
MN  MN	Mongolia
MR  MR	Mauritania
MT  
MU  
MV  
MW  MW	Malawi
MX  MX	Mexico
MY  MY	Malaysia
MZ  MZ	Mozambique
NA  NA	Namibia
NE  NE	Niger							NC	New Caledonia
NG  NG	Nigeria
NI  NI	Nicaragua
NL  NL	Netherlands
NO  NO	Norway
NP  NP	Nepal
NZ  NZ	New Zealand
OM  OM	Oman
PA  PA	Panama
PE  PE	Peru
PG  PG	Papua New Guinea
PH  PH	Philippines
PK  PK	Pakistan
PL  PL	Poland
PT  PT	Portugal								PR	Puerto Rico
PY  PY	Paraguay								PS	Palestine
QA  QA	Qatar
RO  RO	Romania
RS  RS	Serbia
RU  RU	Russia
RW  RW	Rwanda
SA  SA	Saudi Arabia
SB  SB	Solomon Is.
SC  
SD  SD	Sudan
SE  SE	Sweden
SG  
SI  SI	Slovenia
SK  SK	Slovakia
SL  SL	Sierra Leone
SN  SN	Senegal
SR  SR	Suriname											SO	Somalia
ST  
SV  												SS	S. Sudan
SY  												SV	El Salvador
SZ  SZ	Swaziland												SY	Syria
TD  TD	Chad
TG  TF	Fr. S. Antarctic Lands
TH  TG	Togo
TJ  TH	Thailand
TL  TJ	Tajikistan
TM  TL	Timor-Leste
TN  TM	Turkmenistan
TO  TN	Tunisia
TR  TR	Turkey
TT  TT	Trinidad and Tobago
TW  TW	Taiwan
TZ  TZ	Tanzania
UA  UA	Ukraine
UG  UG	Uganda
US  US	United States
UY  UY	Uruguay
UZ  UZ	Uzbekistan
VC  
VE  VE	Venezuela
VN  VN	Vietnam
VU  VU	Vanuatu
WS  							XC	N. Cyprus
YE  							XK	Kosovo
ZA  ZA	South Africa							XS	Somaliland
ZM  ZM	Zambia							YE	Yemen
ZW  ZW	Zimbabwe
